##########
#        #
#  $  .  #
#        #
#  @     #
#        #
##########